## O que são palavras cognatas?

Conforme mencionado, palavras cognatas referem-se aquelas similares na forma e no conteúdo, o que facilita na identificação e compreensão geral do texto, mesmo que o indivíduo não conheça previamente os termos em questão.

Porém, não pense você que essa situação só ocorre na língua inglesa. O português e diversos outros idiomas também abrigam palavras cognatas. Para ter uma melhor compreensão do significado desse termo é só entender a tradução de cognata: vocábulo derivado do latim que traduzido quer dizer palavras que nasceram juntas. Facilitou o entendimento?

Pense em uma mãe que dá a luz a mais de um filho de uma vez. A tendência é que eles possuam similaridade entre eles. A mesma lógica se aplica às palavras cognatas, que por serem derivadas de uma mesma raiz, contam com a mesma origem etimológica.

Entretanto, é preciso ficar de olho nas pegadinhas, que podem confundir o leitor e fazê-lo traduzir uma informação completamente errada. É o caso das falsas cognatas, que mesmo com a similaridade na escrita e pronúncia, mas que possuem significados morfológicos bem distintos. Felizmente, há mais verdadeira cognatas do que falsos, o que diminui as chances de erros.

## Quais são os principais falsos cognatos?

- actually: realmente;
- call: telefonar;
- borrow: emprestar;
- charge: cobrar;
- come: entrar;
- content: conteúdo;
- century: século;
- college: faculdade;
- cops: policiais;
- fill: preencher;
- library: biblioteca;
- lunch: almoço.

Veja abaixo mais alguns exemplos de Falsos Cognatos:

- Palavra em inglês
- Falso cognato em português
- Significado real
- anthem
- antena
- hino
- ingenious
- ingênuo
- engenhoso
- pregnant
- impregnada
- grávida; prenha
- spectacles
- espetáculos
- óculos
- moon
- mão
- lua
- mayor
- major
- prefeito

## Qual a quantidade de cognatos da língua inglesa?

A quantidade de cognatas da língua inglesa com o português é bem grande e isso pode ser usado a favor de quem precisa ler um artigo, por exemplo. Parecidas tanto no significado quanto na forma, as palavras cognatas do inglês para o português muitas vezes representam quase 30% de um texto em inglês, ou seja, será muito útil para quem está se preparando para o exame de proficiência em inglês, por exemplo.

## Como as palavras cognatas podem ser classificadas?

Os cognatos podem ser classificados em:

- idênticos;
- semelhantes;
- vagamente parecidos.

Embora sejam muito úteis, é importante que o estudante fique atento aos falsos cognatos, que são palavras que possuem uma grafia semelhante, mas têm significados totalmente diferentes.

## Quais são os cognatos em inglês mais utilizados? Veja 56 exemplos!

- accidental: acidental;
- angel: anjo;
- area: área;
- banana: banana;
- creation: criação;
- comedy: comédia;
- comic: cômico;
- competition: competição;
- connect: conectar;
- correct: correto;
- coffee: café;
- chocolate: chocolate;
- dance: dança;
- different: diferente;
- economy: economia;
- elephant: elefante;
- emotion: emoção;
- example: exemplo;
- future: futuro;
- garage: garagem;
- giraffe: girafa;
- human: humano;
- honest: honesto;
- hour: hora;
- moment: momento;
- musician: músico;
- name: nome;
- number: número;
- normal: normal;
- object: objeto;
- paint: pintar;
- passport: passaporte;
- patient: paciente;
- present: presente;
- positive: positivo;
- potential: potencial;
- offensive: ofensivo;
- other: outro;
- reaction: reação;
- regular: regular;
- simple: simples
- time: tempo;
- tomato: tomate;
- vegetarian: vegetariano;
- composition: composição;
- human: humano;
- idea: ideia;
- minute: minuto;
- mission: missão;
- music: música;
- important: importante;
- persistente: persistent;
- television: televisão;
- material: material;
- pages: páginas;
- video: vídeo.

Como você viu, as grafias são muito parecidas e algumas das palavras até usamos no dia a dia ao falar, escrever e principalmente ao dar nomes de lojas ou sites. Porém, há também os falsos cognatos, que são aquelas palavras muito parecidas com outras palavras que usamos em português, mas que têm significado completamente diferente.

## Como ler textos em inglês com a técnica das palavras cognatas?

Há várias técnicas usadas para ler textos em inglês mesmo quando não se tem o completo domínio do vocabulário. Elas são ensinadas em cursos de inglês instrumental, muito procurado por estudantes que querem ser aprovados no ENEM ou em um exame de proficiência em inglês de mestrados e doutorados.

### Técnicas de compreensão textual

Dentre essas técnicas está o uso de palavras cognatas como um auxiliar da compreensão textual. Saiba mais sobre elas e entenda por que as palavras cognatas são ensinadas no curso de inglês instrumental. Ao conhecer essas principais palavras, a tendência é que você facilmente decore e assimile elas com outras da língua portuguesa, já que a pronúncia e escrita são tão parecidas.

Isso permite que ao encontrar tais palavras do texto, mesmo que você não consiga traduzi-las por completo, seja possível compreender a ideia principal e ter bons resultados na nota. Porém, para melhor eficácia da técnica, é preciso aprender sobre o assunto em conjunto com o estudo de falsos cognatos. Conforme mencionado, eles atuam como pegadinhas que quando pegam alguém desprevenido, podem atrapalhar toda tradução do texto em inglês.

Conseguiu entender mais sobre as palavras cognatas e a importância de estudar sobre o assunto para fugir de armadilhas que podem comprometer uma nota e, consequentemente, seus sonhos? Felizmente, nada que a aprendizagem do assunto não possa evitar.



## Principais cognatos inglês-português

Veja quais são as principais **palavras cognatas** do idioma inglês para o português e seu significado:

- Accidental: acidental
- Creation: criação
- Comedy: comédia
- Comic: cômico
- Competition: competição
- Composition: composição
- Connect: conectar
- Different: diferente
- Economy: economia
- Emotion: emoção
- Example: exemplo
- Future: futuro
- Garage: garagem
- Human: humano
- Idea: ideia
- Important: importante
- Material: material
- Minute: minuto
- Mission: missão
- Music: música
- Pages: páginas
- Persistente: persistente
- Positive: positivo
- Potential: potencial
- Offensive: ofensivo
- Other: outro
- Reaction: reação
- Regular: regular
- Television: televisão
- Video: vídeo

## Falsos cognatos

**Falsos cognatos ou heterossêmanticos** são palavras cuja grafia em dois idiomas é semelhante, mas a origem em ambas as línguas é distinta, fazendo com o que o significado das palavras em idiomas diferentes apresente divergências.

Existem dois tipos de **falsos cognatos**:

- **Estruturais:** diferem na estrutura gramatical, possuindo uma semelhança na grafia, mas não possuem o mesmo sentindo e o mesmo uso em ambos os idiomas
- **Lexicais:** palavras que possuem a mesma grafia, mas sua tradução é divergente, alterando o sentindo real da palavra.

## Principais falsos cognatos inglês-português

Conheça os principais **falsos cognatos** da língua inglesa para a língua portuguesa, com os seus respectivos significados:

- Actually: realmente
- Borrow: emprestar
- Call: telefonar
- Charge: cobrar
- Century: século
- College: faculdade
- Come: entrar
- Content: conteúdo
- Cops: policiais
- Fill: preencher
- Library: biblioteca
- Lunch: almoço
- Notebook: caderno
- Relatives: parentes
- Refrigerator: geladeira
- Sale: venda
- Say: dizer
- Soda: refrigerante
- Tax: imposto
- Truck: caminhão